################
#      ** *
# # # #*# # #*#
#  **     *** 
# # # # # #*# #
#*         * **
# # # # # # # #
#*         *  *
# # # # #*# # #
#*  * **  *   
# #*# # # # # #
#           *   
################