###############################
#p     ** *                   #
# # # #*# # #*#               #
#  bf     ***                 #
# # # # #1#*# #               #
#*         * **               #
# # # # #p# # #               #
#*         *  *               #
# # # # #*# # #               #
#*  * **  *                   #
# #*# # # # # #               #
#           *                 #
###############################
