###############################
#p     ** *                   #
# # # #x# # #*#               #
#  bf     ***                 #
# # # # #1#*# #               #
#*         * **               #
# # # # # # # #               #
#*         *  *               #
# # # # #*# # #               #
#*  * **  *                   #
# #*# # # # # #               #
#           *                 #
###############################
