###############################
#      ** *                   #
# # # #*# # #*#               #
#  **     ***                 #
# # # # # #*# #               #
#*         * **               #
# # # # # # # #               #
#*         *  *               #
# # # # #*# # #               #
#*  * **  *                   #
# #*# # # # # #               #
#           *                 #
###############################