###############################
#     1** *                   #
# # # #*# # #*#               #
#  bf     ***                 #
#p# # # # #*# #               #
#*         * **               #
# # # # # # # #               #
#*         *  *               #
# # # # #*# # #               #
#*  * **  *                   #
# #*# # # # # #               #
#           *                 #
###############################